*****4444*****
****44**44****
***44****44***
**44******44**
*44********44*
44222222222244
11****22****11
11****22****11
11****22****11
11****22****11
11****22****11
11****22****11