******111*****
**************
22222222222222
22**44****34**
22**4*4**3*4**
22**4**43**4**
22**4**34**4**
22**4*3**4*4**
22**43****44**
22222222222222
**************
******111*****