11**********11
11**********11
*22********22*
**33******33**
***44****44***
*****3223*****
*****3223*****
****44**44****
**33******33**
*22********22*
11**********11
11**********11