11111111111111
11111111111111
11222222222211
11222222222211
11223333332211
11223344332211
11223344332211
11223333332211
11222222222211
11222222222211
11111111111111
11111111111111