**************
**4**4**2222**
**4**4**2222**
**4**4*****2**
**4**4*****2**
**4444**2222**
**4444**2222**
*****4**2*****
*****4**2*****
*****4**2222**
*****4**2222**
**************