11111111111111
11111111111111
**************
22222222222222
22222222222222
**************
**************
33333333333333
33333333333333
**************
44444444444444
44444444444444