*****4444*****
****444444****
***44433444***
**4433223344**
**4332112334**
*4432****2344*
*4432****2344*
**4332112334**
**4433223344**
***44433444***
****444444****
*****4444*****