***44****44***
**4444**4444**
*444444444444*
*444444444444*
44444444444444
*444444444444*
*444444444444*
**4444444444**
***44444444***
****444444****
*****4444*****
******44******