*****1111*****
****111111****
***11122111***
**1122332211**
**1223443221**
*112344443211*
*112344443211*
**1223443221**
**1122332211**
***11122111***
****111111****
*****1111*****